100000000000000000000000000000000000000000000000000000000000000000000000000000000000000000000000000000000000000000000000000000000000000000000000000000000000000000000000
100000000000000000000000000000000000000000000000000000000000000000000000000000000000000000000000000000000000000000000000000000000000000000000000000000000000000000000000
100000000000000000000000000000000000000000000000000000000000000000000000000000000000000000000000000000000000000000000000000000000000000000000000000000000000000000000000
100000000000000000000000000000000000000000000000000000000000000000000000000000000000000000000000000000000000000000000000000000000000000000000000000000000000000000000000
222222222222222222222222222222222222222222222222222222222222222222222222222222220000222222222222222222222222222222222222222222222222222222222222222222222222222222220000
100000000000000000000000000000000000000000000000000000000000000000000000000000000000000000000000000000000000000000000000000000000000000000000000000000000000000000000000
100000000000000000000000000000000000000000000000000000000000000000000000000000000000000000000000000000000000000000000000000000000000000000000000000000000000000000000000
100000000000000000000000000000000000000000000000000000000000000000000000000000000000000000000000000000000000000000000000000000000000000000000000000000000000000000000000
100000000000000000000000000000000000000000000000000000000000000000000000000000000000000000000000000000000000000000000000000000000000000000000000000000000000000000000000
222222222222222222222222222222222222222222222222222222222222222222222222200000022222222222222222222222222222222222222222222222222222222222222222222222222222222222220000
100000000000000000000000000000000000000000000000000000000000000000000000000000050000000000000000000000000000000000000000000000000000000000000000000000000000000000000000
100000000000000000000000000000000000000000000000000000000000000000000000000000050000000000000000000000000000000000000000000000000000000000000000000000000000000000030000
100000000000000000000000000000000000000000000000000000000000000000000000000000050000000000000000000000000000000000000000000000000000000000000000000000000000000000050000
100000000000000000000000000000000000000000000000000000000000000000000000000000050000000000000000000000000000000000000000000000000000000000000000000000000000000000050000
100000000000000000000000000000000000000000000000000000000000000000000000000000050000000000000000000000000000000000000000000000000000000000000000000000000000000000050000
100000000000000000000000000000000000000000000000000000000000000000000000000000050000000000000000000000000000000000000000000000000000000000000000000000000000000000050000
222220000000000000000000000000000000000000000000000000000000000000000000222222250000000000000000000000000000000000000000000000000000000000000000000000000000222222250000
100000000000000000000000000000000000000000000000000000000000000000022222000000000000000000000000000000000000000000000000000000000000000000000000000000022222000000050000
100000000000000000000000000000000000000000000000000000000000002222200000000000000000000000000000000000000000000000000000000000000000000000000000002222200000000000050000
100002222222200000000000000000000000000000000000000000000022220000000000000000000000000000000000000000000000000000000000000000000000000000000022220000000000000000050000
100000000000000000000000000000000000000000000000000000000000000000000000000000000000000000000000000000000000000000000000000000000000000000000000000000000000000000050000
100000000000000000002222222220000000000000000000000000000000000000000000000000000000000000000000000000222222222222000000000000000000000000000000000000000000000000050000
100000000000000000000000000000000000000000000000000000000000000000000000000000000000000000000000000000000000000000000000000000000000000000000000000000000000000000050000
222222222222222240000000000000003222222222222222222222222222221000000000000000000000000222222222222222222222222222222222222222222222222222222222222222222222222222210000
111111111111111160000000000000005000000000000000000000000000000222222222222222210000001111111111111111111111111111111111111111111111111111111111111111111111111111110000
111111111111111160000000000000005000000000000000000000000000000000000000000000000000011111111111111111111111111111111111111111111111111111111111111111111111111111110000
111111111111111160000000000000005000000000000000000000000000000000000000000000000000111111111111111111111111111111111111111111111111111111111111111111111111111111110000
111111111111111160000000000000005000000000000000000000000000000000000000000000000000111111111111111111111111111111111111111111111111111111111111111111111111111111110000
111111111111111160000000000000005111111111111111111111111111110000000000000000000000111111111111111111111111111111111111111111111111111111111111111111111111111111110000
111111111111111160000000000000005000000000000000000000000000000000000000000000000000111111111111111111111111111111111111111111111111111111111111111111111111111111110000
111111111111111160000000000000005000000000000000000000000000000000000000000000000000111111111111111111111111111111111111111111111111111111111111111111111111111111110000
111111111111111160000000000000005000000000000000000000000000000000000000000000000000111111111111111111111111111111111111111111111111111111111111111111111111111111110000
111111111111111160000000000000005000000000000000000000001111111111111111111111110000111111111111111111111111111111111111111111111111111111111111111111111111111111110000
111111111111111160000000000000005000000000000000000000000000000000000000000000010000111111111111111111111111111111111111111111111111111111111111111111111111111111110000
111111111111111160000000000000005000000000000000000000000000000000000000000000010000111111111111111111111111111111111111111111111111111111111111111111111111111111110000
111111111111111160000000000000005000000000000000000000000000000000000000000000010000111111111111111111111111111111111111111111111111111111111111111111111111111111110000
111111111111111160000000000000005000000000000000000000000000000000000000000000010000111111111111111111111111111111111111111111111111111111111111111111111111111111110000
111111111111111160000000000000005111111111111111111111111111100000000000000000010000111111111111111111111111111111111111111111111111111111111111111111111111111111110000
111111111111111160000000000000000000000000000000000000000000000000000000000000010000111111111111111111111111111111111111111111111111111111111111111111111111111111110000
111111111111111160000000000000000000000000000000000000000000000000000000000000010000111111111111111111111111111111111111111111111111111111111111111111111111111111110000
111111111111111160000000000000000000000000000000000000000000000000000000000000010000111111111111111111111111111111111111111111111111111111111111111111111111111111110000
111111111111111160000000000000000000000000000000000000000000000000011111111111110000111111111111111111111111111111111111111111111111111111111111111111111111111111110000
111111111111111160000000000000000000000000000000000000000000000000000000000000000000000000000000000000000000000000000000000000000000000000000000000000000000000000000000
111111111111111160000000000000000000000000000000000000000000000000000000000000000000000000000000000000000000000000000000000000000000000000000000000000000000000000000000
111111111111111160000000000000000000000000000000000000000000000000000000000000000000000000000000000000000000000000000000000000000000000000000000000000000000000000000000
111111111111111111111111111111111111111111111111111111111111111111111111111111111111111111111111111111111111111111111111111111111111111111111111111111111111111111111111