000000000000000000000
010000010000001000000
001000010000001000000
001000100000010000000
010100100000010000000
010101000000100000000
001011000000100000000
001010000001000000000
000101000001000000000
000101000010000000000
000010100010000000000
000010100100000000000
000001010100000000000
000001011000000000000
000000001000000000000
000000000000000000000